# ######################### #
#   ###           #####     #
###     #########       #####
#######        ######## #####
##################    #    ##
#    #    #        ##B#### ##
# ## # ## # ## ### ####### ##
# ##   ##   ##  ##         ##
# ######### #################
#       ######       ########
#######        ##### ##     #
# ##################    ### #
#                  ######## #
# ######################### #
#                           #
#A###########################
