###B#########################
# # #########      ####     #
# # #   #   # ############# #
#     #   #                 #
######################## ####
# #                #     ## #
# # ############## # ###### #
#                # #        #
# ############## #   ########
#    ########### #####    ###
######     ##    ##### ## ###
#    # ### ## #####    #  # #
# ## ##### ##       ####### #
# #####    ########     #   #
#     ####       #### # # ###
# ###      #####      #     #
#A###########################