#############################
#        #                  #
##### ##### ###### ######## #
#                # ##  B# # #
# ################ ## ### # #
# # # #          # ## # #   #
#       ### ## # #      #####
# ####### #### ##########  ##
# # # #         #   #   ##  #
#   #   ### ##### # # #   # #
###########       #   ###   #
# #   #   # #################
# # # # # # #  #        #   #
# # # # # # # ### ##### ### #
A   #   #           #       #
#############################